######################################################
#@..#................................................#
#....................................................#
#####................................................#
#............#.......................................#
#....................................................#
#....................................................#
#....................................................#
#....................................................#
#....................................................#
#....................................................#
#....................................................#
#....................................................#
#....................................................#
#....................................................#
#....................................................#
#....................................................#
######################################################